trial_number,strategy,tube_state,action,spout_state,feedback,profit,total_reward,total_timeouts,total_null
1,Random,NOGO,Wait,OFF,Null,0,0,0,1
2,Random,NOGO,Wait,OFF,Null,0,0,0,2
3,Random,GO,Lick,ON,Reward,1,1,0,2
4,Random,CHECK,Lick,OFF,Null,1,1,0,3
5,Random,NOGO,Lick,OFF,Timeout,0,1,1,3
6,Random,CHECK,Lick,OFF,Null,0,1,1,4
7,Random,CHECK,Lick,OFF,Null,0,1,1,5
8,Random,NOGO,Lick,OFF,Timeout,-1,1,2,5
9,Random,NOGO,Lick,OFF,Timeout,-2,1,3,5
10,Random,NOGO,Lick,OFF,Timeout,-3,1,4,5
11,Random,GO,Wait,ON,Null,-3,1,4,6
12,Random,CHECK,Lick,OFF,Null,-3,1,4,7
13,Random,GO,Lick,ON,Reward,-2,2,4,7
14,Random,GO,Wait,ON,Null,-2,2,4,8
15,Random,GO,Wait,ON,Null,-2,2,4,9
16,Random,NOGO,Wait,OFF,Null,-2,2,4,10
17,Random,NOGO,Wait,OFF,Null,-2,2,4,11
18,Random,CHECK,Wait,OFF,Null,-2,2,4,12
19,Random,CHECK,Lick,OFF,Null,-2,2,4,13
20,Random,CHECK,Wait,OFF,Null,-2,2,4,14
21,Random,CHECK,Lick,OFF,Null,-2,2,4,15
22,Random,NOGO,Lick,OFF,Timeout,-3,2,5,15
23,Random,NOGO,Lick,OFF,Timeout,-4,2,6,15
24,Random,GO,Wait,ON,Null,-4,2,6,16
25,Random,GO,Lick,ON,Reward,-3,3,6,16
26,Random,CHECK,Lick,OFF,Null,-3,3,6,17
27,Random,GO,Wait,ON,Null,-3,3,6,18
28,Random,NOGO,Lick,OFF,Timeout,-4,3,7,18
29,Random,GO,Lick,ON,Reward,-3,4,7,18
30,Random,NOGO,Wait,OFF,Null,-3,4,7,19
31,Random,NOGO,Lick,OFF,Timeout,-4,4,8,19
32,Random,CHECK,Wait,OFF,Null,-4,4,8,20
33,Random,NOGO,Lick,OFF,Timeout,-5,4,9,20
34,Random,GO,Lick,ON,Reward,-4,5,9,20
35,Random,NOGO,Lick,OFF,Timeout,-5,5,10,20
1,Always Lick,NOGO,Lick,OFF,Timeout,-1,0,1,0
2,Always Lick,CHECK,Lick,OFF,Null,-1,0,1,1
3,Always Lick,NOGO,Lick,OFF,Timeout,-2,0,2,1
4,Always Lick,NOGO,Lick,OFF,Timeout,-3,0,3,1
5,Always Lick,NOGO,Lick,OFF,Timeout,-4,0,4,1
6,Always Lick,NOGO,Lick,OFF,Timeout,-5,0,5,1
7,Always Lick,GO,Lick,ON,Reward,-4,1,5,1
8,Always Lick,NOGO,Lick,OFF,Timeout,-5,1,6,1
9,Always Lick,NOGO,Lick,OFF,Timeout,-6,1,7,1
10,Always Lick,CHECK,Lick,OFF,Null,-6,1,7,2
11,Always Lick,CHECK,Lick,OFF,Null,-6,1,7,3
12,Always Lick,NOGO,Lick,OFF,Timeout,-7,1,8,3
13,Always Lick,GO,Lick,ON,Reward,-6,2,8,3
14,Always Lick,GO,Lick,ON,Reward,-5,3,8,3
15,Always Lick,GO,Lick,ON,Reward,-4,4,8,3
16,Always Lick,GO,Lick,ON,Reward,-3,5,8,3
17,Always Lick,GO,Lick,ON,Reward,-2,6,8,3
18,Always Lick,CHECK,Lick,OFF,Null,-2,6,8,4
19,Always Lick,GO,Lick,ON,Reward,-1,7,8,4
20,Always Lick,GO,Lick,ON,Reward,0,8,8,4
21,Always Lick,NOGO,Lick,OFF,Timeout,-1,8,9,4
22,Always Lick,NOGO,Lick,OFF,Timeout,-2,8,10,4
23,Always Lick,NOGO,Lick,OFF,Timeout,-3,8,11,4
24,Always Lick,GO,Lick,ON,Reward,-2,9,11,4
25,Always Lick,NOGO,Lick,OFF,Timeout,-3,9,12,4
26,Always Lick,NOGO,Lick,OFF,Timeout,-4,9,13,4
27,Always Lick,NOGO,Lick,OFF,Timeout,-5,9,14,4
28,Always Lick,NOGO,Lick,OFF,Timeout,-6,9,15,4
29,Always Lick,GO,Lick,ON,Reward,-5,10,15,4
30,Always Lick,NOGO,Lick,OFF,Timeout,-6,10,16,4
31,Always Lick,CHECK,Lick,OFF,Null,-6,10,16,5
32,Always Lick,NOGO,Lick,OFF,Timeout,-7,10,17,5
33,Always Lick,NOGO,Lick,OFF,Timeout,-8,10,18,5
34,Always Lick,GO,Lick,ON,Reward,-7,11,18,5
35,Always Lick,NOGO,Lick,OFF,Timeout,-8,11,19,5
1,Periodic,NOGO,Wait,OFF,Null,0,0,0,1
2,Periodic,GO,Wait,ON,Null,0,0,0,2
3,Periodic,GO,Lick,ON,Reward,1,1,0,2
4,Periodic,GO,Lick,ON,Reward,2,2,0,2
5,Periodic,GO,Wait,ON,Null,2,2,0,3
6,Periodic,GO,Wait,ON,Null,2,2,0,4
7,Periodic,NOGO,Wait,OFF,Null,2,2,0,5
8,Periodic,NOGO,Lick,OFF,Timeout,1,2,1,5
9,Periodic,GO,Lick,ON,Reward,2,3,1,5
10,Periodic,NOGO,Wait,OFF,Null,2,3,1,6
11,Periodic,NOGO,Wait,OFF,Null,2,3,1,7
12,Periodic,NOGO,Wait,OFF,Null,2,3,1,8
13,Periodic,NOGO,Lick,OFF,Timeout,1,3,2,8
14,Periodic,NOGO,Lick,OFF,Timeout,0,3,3,8
15,Periodic,GO,Wait,ON,Null,0,3,3,9
16,Periodic,CHECK,Wait,OFF,Null,0,3,3,10
17,Periodic,NOGO,Wait,OFF,Null,0,3,3,11
18,Periodic,NOGO,Lick,OFF,Timeout,-1,3,4,11
19,Periodic,NOGO,Lick,OFF,Timeout,-2,3,5,11
20,Periodic,NOGO,Wait,OFF,Null,-2,3,5,12
21,Periodic,GO,Wait,ON,Null,-2,3,5,13
22,Periodic,NOGO,Wait,OFF,Null,-2,3,5,14
23,Periodic,GO,Lick,ON,Reward,-1,4,5,14
24,Periodic,GO,Lick,ON,Reward,0,5,5,14
25,Periodic,CHECK,Wait,OFF,Null,0,5,5,15
26,Periodic,NOGO,Wait,OFF,Null,0,5,5,16
27,Periodic,GO,Wait,ON,Null,0,5,5,17
28,Periodic,NOGO,Lick,OFF,Timeout,-1,5,6,17
29,Periodic,CHECK,Lick,OFF,Null,-1,5,6,18
30,Periodic,NOGO,Wait,OFF,Null,-1,5,6,19
31,Periodic,GO,Wait,ON,Null,-1,5,6,20
32,Periodic,NOGO,Wait,OFF,Null,-1,5,6,21
33,Periodic,NOGO,Lick,OFF,Timeout,-2,5,7,21
34,Periodic,NOGO,Lick,OFF,Timeout,-3,5,8,21
35,Periodic,GO,Wait,ON,Null,-3,5,8,22
1,Plastic,NOGO,Lick,OFF,Timeout,-1,0,1,0
2,Plastic,NOGO,Lick,OFF,Timeout,-2,0,2,0
3,Plastic,CHECK,Lick,OFF,Null,-2,0,2,1
4,Plastic,CHECK,Lick,OFF,Null,-2,0,2,2
5,Plastic,CHECK,Lick,OFF,Null,-2,0,2,3
6,Plastic,NOGO,Lick,OFF,Timeout,-3,0,3,3
7,Plastic,NOGO,Wait,OFF,Null,-3,0,3,4
8,Plastic,GO,Wait,ON,Null,-3,0,3,5
9,Plastic,NOGO,Wait,OFF,Null,-3,0,3,6
10,Plastic,NOGO,Wait,OFF,Null,-3,0,3,7
11,Plastic,GO,Wait,ON,Null,-3,0,3,8
12,Plastic,NOGO,Wait,OFF,Null,-3,0,3,9
13,Plastic,CHECK,Lick,OFF,Null,-3,0,3,10
14,Plastic,NOGO,Lick,OFF,Timeout,-4,0,4,10
15,Plastic,NOGO,Lick,OFF,Timeout,-5,0,5,10
16,Plastic,NOGO,Lick,OFF,Timeout,-6,0,6,10
17,Plastic,GO,Wait,ON,Null,-6,0,6,11
18,Plastic,CHECK,Wait,OFF,Null,-6,0,6,12
19,Plastic,CHECK,Wait,OFF,Null,-6,0,6,13
20,Plastic,GO,Wait,ON,Null,-6,0,6,14
21,Plastic,NOGO,Wait,OFF,Null,-6,0,6,15
22,Plastic,NOGO,Lick,OFF,Timeout,-7,0,7,15
23,Plastic,GO,Wait,ON,Null,-7,0,7,16
24,Plastic,NOGO,Wait,OFF,Null,-7,0,7,17
25,Plastic,NOGO,Lick,OFF,Timeout,-8,0,8,17
26,Plastic,CHECK,Wait,OFF,Null,-8,0,8,18
27,Plastic,CHECK,Lick,OFF,Null,-8,0,8,19
28,Plastic,GO,Wait,ON,Null,-8,0,8,20
29,Plastic,NOGO,Lick,OFF,Timeout,-9,0,9,20
30,Plastic,NOGO,Lick,OFF,Timeout,-10,0,10,20
31,Plastic,CHECK,Lick,OFF,Null,-10,0,10,21
32,Plastic,NOGO,Wait,OFF,Null,-10,0,10,22
33,Plastic,NOGO,Lick,OFF,Timeout,-11,0,11,22
34,Plastic,NOGO,Lick,OFF,Timeout,-12,0,12,22
35,Plastic,NOGO,Lick,OFF,Timeout,-13,0,13,22
1,Adaptive,NOGO,Lick,OFF,Timeout,-1,0,1,0
2,Adaptive,GO,Wait,ON,Null,-1,0,1,1
3,Adaptive,NOGO,Lick,OFF,Timeout,-2,0,2,1
4,Adaptive,CHECK,Wait,OFF,Null,-2,0,2,2
5,Adaptive,NOGO,Lick,OFF,Timeout,-3,0,3,2
6,Adaptive,GO,Lick,ON,Reward,-2,1,3,2
7,Adaptive,NOGO,Lick,OFF,Timeout,-3,1,4,2
8,Adaptive,NOGO,Lick,OFF,Timeout,-4,1,5,2
9,Adaptive,NOGO,Wait,OFF,Null,-4,1,5,3
10,Adaptive,NOGO,Wait,OFF,Null,-4,1,5,4
11,Adaptive,CHECK,Lick,OFF,Null,-4,1,5,5
12,Adaptive,NOGO,Lick,OFF,Timeout,-5,1,6,5
13,Adaptive,GO,Wait,ON,Null,-5,1,6,6
14,Adaptive,NOGO,Wait,OFF,Null,-5,1,6,7
15,Adaptive,GO,Lick,ON,Reward,-4,2,6,7
16,Adaptive,NOGO,Wait,OFF,Null,-4,2,6,8
17,Adaptive,GO,Lick,ON,Reward,-3,3,6,8
18,Adaptive,NOGO,Wait,OFF,Null,-3,3,6,9
19,Adaptive,NOGO,Wait,OFF,Null,-3,3,6,10
20,Adaptive,GO,Wait,ON,Null,-3,3,6,11
21,Adaptive,CHECK,Wait,OFF,Null,-3,3,6,12
22,Adaptive,NOGO,Wait,OFF,Null,-3,3,6,13
23,Adaptive,GO,Wait,ON,Null,-3,3,6,14
24,Adaptive,NOGO,Wait,OFF,Null,-3,3,6,15
25,Adaptive,GO,Wait,ON,Null,-3,3,6,16
26,Adaptive,GO,Wait,ON,Null,-3,3,6,17
27,Adaptive,CHECK,Wait,OFF,Null,-3,3,6,18
28,Adaptive,GO,Wait,ON,Null,-3,3,6,19
29,Adaptive,NOGO,Wait,OFF,Null,-3,3,6,20
30,Adaptive,NOGO,Wait,OFF,Null,-3,3,6,21
31,Adaptive,CHECK,Wait,OFF,Null,-3,3,6,22
32,Adaptive,CHECK,Wait,OFF,Null,-3,3,6,23
33,Adaptive,GO,Wait,ON,Null,-3,3,6,24
34,Adaptive,NOGO,Wait,OFF,Null,-3,3,6,25
35,Adaptive,GO,Wait,ON,Null,-3,3,6,26
1,Intuitive,NOGO,Lick,OFF,Timeout,-1,0,1,0
2,Intuitive,NOGO,Wait,OFF,Null,-1,0,1,1
3,Intuitive,GO,Wait,ON,Null,-1,0,1,2
4,Intuitive,CHECK,Lick,OFF,Null,-1,0,1,3
5,Intuitive,GO,Wait,ON,Null,-1,0,1,4
6,Intuitive,GO,Wait,ON,Null,-1,0,1,5
7,Intuitive,NOGO,Lick,OFF,Timeout,-2,0,2,5
8,Intuitive,NOGO,Lick,OFF,Timeout,-3,0,3,5
9,Intuitive,GO,Wait,ON,Null,-3,0,3,6
10,Intuitive,NOGO,Lick,OFF,Timeout,-4,0,4,6
11,Intuitive,GO,Wait,ON,Null,-4,0,4,7
12,Intuitive,GO,Wait,ON,Null,-4,0,4,8
13,Intuitive,NOGO,Wait,OFF,Null,-4,0,4,9
14,Intuitive,GO,Wait,ON,Null,-4,0,4,10
15,Intuitive,GO,Lick,ON,Reward,-3,1,4,10
16,Intuitive,GO,Lick,ON,Reward,-2,2,4,10
17,Intuitive,NOGO,Lick,OFF,Timeout,-3,2,5,10
18,Intuitive,CHECK,Lick,OFF,Null,-3,2,5,11
19,Intuitive,CHECK,Lick,OFF,Null,-3,2,5,12
20,Intuitive,NOGO,Wait,OFF,Null,-3,2,5,13
21,Intuitive,NOGO,Lick,OFF,Timeout,-4,2,6,13
22,Intuitive,GO,Wait,ON,Null,-4,2,6,14
23,Intuitive,NOGO,Wait,OFF,Null,-4,2,6,15
24,Intuitive,NOGO,Lick,OFF,Timeout,-5,2,7,15
25,Intuitive,NOGO,Wait,OFF,Null,-5,2,7,16
26,Intuitive,GO,Lick,ON,Reward,-4,3,7,16
27,Intuitive,GO,Lick,ON,Reward,-3,4,7,16
28,Intuitive,NOGO,Lick,OFF,Timeout,-4,4,8,16
29,Intuitive,GO,Lick,ON,Reward,-3,5,8,16
30,Intuitive,GO,Lick,ON,Reward,-2,6,8,16
31,Intuitive,NOGO,Lick,OFF,Timeout,-3,6,9,16
32,Intuitive,NOGO,Lick,OFF,Timeout,-4,6,10,16
33,Intuitive,NOGO,Lick,OFF,Timeout,-5,6,11,16
34,Intuitive,CHECK,Wait,OFF,Null,-5,6,11,17
35,Intuitive,NOGO,Wait,OFF,Null,-5,6,11,18
1,Stochastic,NOGO,Wait,OFF,Null,0,0,0,1
2,Stochastic,NOGO,Lick,OFF,Timeout,-1,0,1,1
3,Stochastic,NOGO,Wait,OFF,Null,-1,0,1,2
4,Stochastic,NOGO,Lick,OFF,Timeout,-2,0,2,2
5,Stochastic,CHECK,Wait,OFF,Null,-2,0,2,3
6,Stochastic,NOGO,Wait,OFF,Null,-2,0,2,4
7,Stochastic,CHECK,Lick,OFF,Null,-2,0,2,5
8,Stochastic,NOGO,Lick,OFF,Timeout,-3,0,3,5
9,Stochastic,CHECK,Lick,OFF,Null,-3,0,3,6
10,Stochastic,CHECK,Lick,OFF,Null,-3,0,3,7
11,Stochastic,NOGO,Wait,OFF,Null,-3,0,3,8
12,Stochastic,GO,Lick,ON,Reward,-2,1,3,8
13,Stochastic,NOGO,Wait,OFF,Null,-2,1,3,9
14,Stochastic,GO,Wait,ON,Null,-2,1,3,10
15,Stochastic,GO,Wait,ON,Null,-2,1,3,11
16,Stochastic,NOGO,Wait,OFF,Null,-2,1,3,12
17,Stochastic,NOGO,Wait,OFF,Null,-2,1,3,13
18,Stochastic,CHECK,Lick,OFF,Null,-2,1,3,14
19,Stochastic,NOGO,Lick,OFF,Timeout,-3,1,4,14
20,Stochastic,GO,Wait,ON,Null,-3,1,4,15
21,Stochastic,GO,Lick,ON,Reward,-2,2,4,15
22,Stochastic,NOGO,Wait,OFF,Null,-2,2,4,16
23,Stochastic,CHECK,Wait,OFF,Null,-2,2,4,17
24,Stochastic,NOGO,Wait,OFF,Null,-2,2,4,18
25,Stochastic,CHECK,Wait,OFF,Null,-2,2,4,19
26,Stochastic,CHECK,Lick,OFF,Null,-2,2,4,20
27,Stochastic,NOGO,Lick,OFF,Timeout,-3,2,5,20
28,Stochastic,GO,Lick,ON,Reward,-2,3,5,20
29,Stochastic,NOGO,Wait,OFF,Null,-2,3,5,21
30,Stochastic,NOGO,Wait,OFF,Null,-2,3,5,22
31,Stochastic,CHECK,Wait,OFF,Null,-2,3,5,23
32,Stochastic,NOGO,Wait,OFF,Null,-2,3,5,24
33,Stochastic,NOGO,Wait,OFF,Null,-2,3,5,25
34,Stochastic,NOGO,Wait,OFF,Null,-2,3,5,26
35,Stochastic,NOGO,Lick,OFF,Timeout,-3,3,6,26
1,Jackpot,NOGO,Lick,OFF,Timeout,-1,0,1,0
2,Jackpot,CHECK,Wait,OFF,Null,-1,0,1,1
3,Jackpot,GO,Lick,ON,Reward,0,1,1,1
4,Jackpot,CHECK,Wait,OFF,Null,0,1,1,2
5,Jackpot,GO,Wait,ON,Null,0,1,1,3
6,Jackpot,NOGO,Lick,OFF,Timeout,-1,1,2,3
7,Jackpot,NOGO,Wait,OFF,Null,-1,1,2,4
8,Jackpot,GO,Wait,ON,Null,-1,1,2,5
9,Jackpot,CHECK,Lick,OFF,Null,-1,1,2,6
10,Jackpot,GO,Lick,ON,Reward,0,2,2,6
11,Jackpot,NOGO,Lick,OFF,Timeout,-1,2,3,6
12,Jackpot,NOGO,Lick,OFF,Timeout,-2,2,4,6
13,Jackpot,NOGO,Wait,OFF,Null,-2,2,4,7
14,Jackpot,GO,Wait,ON,Null,-2,2,4,8
15,Jackpot,GO,Lick,ON,Reward,-1,3,4,8
16,Jackpot,GO,Lick,ON,Reward,0,4,4,8
17,Jackpot,CHECK,Lick,OFF,Null,0,4,4,9
18,Jackpot,NOGO,Lick,OFF,Timeout,-1,4,5,9
19,Jackpot,NOGO,Wait,OFF,Null,-1,4,5,10
20,Jackpot,GO,Lick,ON,Reward,0,5,5,10
21,Jackpot,NOGO,Lick,OFF,Timeout,-1,5,6,10
22,Jackpot,NOGO,Lick,OFF,Timeout,-2,5,7,10
23,Jackpot,NOGO,Lick,OFF,Timeout,-3,5,8,10
24,Jackpot,GO,Wait,ON,Null,-3,5,8,11
25,Jackpot,NOGO,Lick,OFF,Timeout,-4,5,9,11
26,Jackpot,CHECK,Lick,OFF,Null,-4,5,9,12
27,Jackpot,NOGO,Wait,OFF,Null,-4,5,9,13
28,Jackpot,CHECK,Lick,OFF,Null,-4,5,9,14
29,Jackpot,NOGO,Lick,OFF,Timeout,-5,5,10,14
30,Jackpot,NOGO,Wait,OFF,Null,-5,5,10,15
31,Jackpot,GO,Lick,ON,Reward,-4,6,10,15
32,Jackpot,NOGO,Lick,OFF,Timeout,-5,6,11,15
33,Jackpot,GO,Lick,ON,Reward,-4,7,11,15
34,Jackpot,NOGO,Wait,OFF,Null,-4,7,11,16
35,Jackpot,NOGO,Lick,OFF,Timeout,-5,7,12,16
1,Decay,NOGO,Wait,OFF,Null,0,0,0,1
2,Decay,GO,Lick,ON,Reward,1,1,0,1
3,Decay,GO,Lick,ON,Reward,2,2,0,1
4,Decay,GO,Wait,ON,Null,2,2,0,2
5,Decay,CHECK,Lick,OFF,Null,2,2,0,3
6,Decay,NOGO,Wait,OFF,Null,2,2,0,4
7,Decay,GO,Lick,ON,Reward,3,3,0,4
8,Decay,GO,Lick,ON,Reward,4,4,0,4
9,Decay,GO,Lick,ON,Reward,5,5,0,4
10,Decay,GO,Wait,ON,Null,5,5,0,5
11,Decay,GO,Wait,ON,Null,5,5,0,6
12,Decay,NOGO,Wait,OFF,Null,5,5,0,7
13,Decay,CHECK,Wait,OFF,Null,5,5,0,8
14,Decay,NOGO,Lick,OFF,Timeout,4,5,1,8
15,Decay,GO,Lick,ON,Reward,5,6,1,8
16,Decay,GO,Wait,ON,Null,5,6,1,9
17,Decay,NOGO,Wait,OFF,Null,5,6,1,10
18,Decay,NOGO,Wait,OFF,Null,5,6,1,11
19,Decay,NOGO,Lick,OFF,Timeout,4,6,2,11
20,Decay,NOGO,Wait,OFF,Null,4,6,2,12
21,Decay,GO,Lick,ON,Reward,5,7,2,12
22,Decay,NOGO,Lick,OFF,Timeout,4,7,3,12
23,Decay,NOGO,Wait,OFF,Null,4,7,3,13
24,Decay,CHECK,Lick,OFF,Null,4,7,3,14
25,Decay,NOGO,Wait,OFF,Null,4,7,3,15
26,Decay,NOGO,Lick,OFF,Timeout,3,7,4,15
27,Decay,NOGO,Wait,OFF,Null,3,7,4,16
28,Decay,NOGO,Wait,OFF,Null,3,7,4,17
29,Decay,GO,Lick,ON,Reward,4,8,4,17
30,Decay,NOGO,Wait,OFF,Null,4,8,4,18
31,Decay,NOGO,Wait,OFF,Null,4,8,4,19
32,Decay,CHECK,Lick,OFF,Null,4,8,4,20
33,Decay,GO,Wait,ON,Null,4,8,4,21
34,Decay,GO,Wait,ON,Null,4,8,4,22
35,Decay,GO,Lick,ON,Reward,5,9,4,22
1,Empirical,NOGO,Wait,OFF,Null,0,0,0,1
2,Empirical,NOGO,Wait,OFF,Null,0,0,0,2
3,Empirical,GO,Wait,ON,Null,0,0,0,3
4,Empirical,CHECK,Wait,OFF,Null,0,0,0,4
5,Empirical,CHECK,Lick,OFF,Null,0,0,0,5
6,Empirical,NOGO,Lick,OFF,Timeout,-1,0,1,5
7,Empirical,GO,Wait,ON,Null,-1,0,1,6
8,Empirical,CHECK,Wait,OFF,Null,-1,0,1,7
9,Empirical,NOGO,Wait,OFF,Null,-1,0,1,8
10,Empirical,NOGO,Wait,OFF,Null,-1,0,1,9
11,Empirical,NOGO,Wait,OFF,Null,-1,0,1,10
12,Empirical,CHECK,Wait,OFF,Null,-1,0,1,11
13,Empirical,NOGO,Wait,OFF,Null,-1,0,1,12
14,Empirical,NOGO,Wait,OFF,Null,-1,0,1,13
15,Empirical,GO,Wait,ON,Null,-1,0,1,14
16,Empirical,GO,Lick,ON,Reward,0,1,1,14
17,Empirical,NOGO,Wait,OFF,Null,0,1,1,15
18,Empirical,NOGO,Wait,OFF,Null,0,1,1,16
19,Empirical,NOGO,Wait,OFF,Null,0,1,1,17
20,Empirical,NOGO,Wait,OFF,Null,0,1,1,18
21,Empirical,NOGO,Wait,OFF,Null,0,1,1,19
22,Empirical,NOGO,Wait,OFF,Null,0,1,1,20
23,Empirical,CHECK,Wait,OFF,Null,0,1,1,21
24,Empirical,NOGO,Wait,OFF,Null,0,1,1,22
25,Empirical,GO,Lick,ON,Reward,1,2,1,22
26,Empirical,CHECK,Wait,OFF,Null,1,2,1,23
27,Empirical,GO,Lick,ON,Reward,2,3,1,23
28,Empirical,GO,Lick,ON,Reward,3,4,1,23
29,Empirical,NOGO,Wait,OFF,Null,3,4,1,24
30,Empirical,CHECK,Wait,OFF,Null,3,4,1,25
31,Empirical,NOGO,Wait,OFF,Null,3,4,1,26
32,Empirical,NOGO,Wait,OFF,Null,3,4,1,27
33,Empirical,NOGO,Wait,OFF,Null,3,4,1,28
34,Empirical,NOGO,Wait,OFF,Null,3,4,1,29
35,Empirical,NOGO,Wait,OFF,Null,3,4,1,30
1,QLearningAgent,NOGO,Lick,OFF,Timeout,-1,0,1,0
2,QLearningAgent,NOGO,Wait,OFF,Null,-1,0,1,1
3,QLearningAgent,NOGO,Wait,OFF,Null,-1,0,1,2
4,QLearningAgent,CHECK,Lick,OFF,Null,-1,0,1,3
5,QLearningAgent,GO,Lick,ON,Reward,0,1,1,3
6,QLearningAgent,GO,Lick,ON,Reward,1,2,1,3
7,QLearningAgent,CHECK,Lick,OFF,Null,1,2,1,4
8,QLearningAgent,GO,Lick,ON,Reward,2,3,1,4
9,QLearningAgent,CHECK,Lick,OFF,Null,2,3,1,5
10,QLearningAgent,CHECK,Lick,OFF,Null,2,3,1,6
11,QLearningAgent,CHECK,Lick,OFF,Null,2,3,1,7
12,QLearningAgent,GO,Lick,ON,Reward,3,4,1,7
13,QLearningAgent,CHECK,Lick,OFF,Null,3,4,1,8
14,QLearningAgent,NOGO,Wait,OFF,Null,3,4,1,9
15,QLearningAgent,NOGO,Wait,OFF,Null,3,4,1,10
16,QLearningAgent,GO,Lick,ON,Reward,4,5,1,10
17,QLearningAgent,GO,Lick,ON,Reward,5,6,1,10
18,QLearningAgent,GO,Lick,ON,Reward,6,7,1,10
19,QLearningAgent,GO,Lick,ON,Reward,7,8,1,10
20,QLearningAgent,NOGO,Wait,OFF,Null,7,8,1,11
21,QLearningAgent,GO,Lick,ON,Reward,8,9,1,11
22,QLearningAgent,NOGO,Wait,OFF,Null,8,9,1,12
23,QLearningAgent,GO,Lick,ON,Reward,9,10,1,12
24,QLearningAgent,NOGO,Wait,OFF,Null,9,10,1,13
25,QLearningAgent,NOGO,Wait,OFF,Null,9,10,1,14
26,QLearningAgent,CHECK,Lick,OFF,Null,9,10,1,15
27,QLearningAgent,GO,Lick,ON,Reward,10,11,1,15
28,QLearningAgent,NOGO,Wait,OFF,Null,10,11,1,16
29,QLearningAgent,CHECK,Lick,OFF,Null,10,11,1,17
30,QLearningAgent,NOGO,Wait,OFF,Null,10,11,1,18
31,QLearningAgent,NOGO,Wait,OFF,Null,10,11,1,19
32,QLearningAgent,NOGO,Wait,OFF,Null,10,11,1,20
33,QLearningAgent,GO,Lick,ON,Reward,11,12,1,20
34,QLearningAgent,NOGO,Wait,OFF,Null,11,12,1,21
35,QLearningAgent,NOGO,Wait,OFF,Null,11,12,1,22
